{
  "id": "maze3",
  "name": "Maze 3",
  "pattern": [
    "########################",
    "#.........#.....#......#",
    "#.##.###.######.#.#.##.#",
    "#.##.....######.....##.#",
    "#.##.###.######.###.##.#",
    "#.....#......#.........#",
    "#.##.###.##.###.###.##.#",
    "#....###.##.###.###....#",
    "#.##.###.##.###.###.##.#",
    "#........##E###........#",
    "#.##.##.##HGHG##.##.##.#",
    "#.##....##HHHH##....##.#",
    "#.##.#####GHGH#####.##.#",
    "#.#..##############.##.#",
    "#...#......#.....#.....#",
    "#.###.##.######.##.###.#",
    "#.....##.######.##.....#",
    "#.###.##.######.######.#",
    "#.....#......#.........#",
    "#.##.###.######.###.##.#",
    "#.##.###.######.###.##.#",
    "#.........#.....#......#",
    "#.##.###.######.#.#.##.#",
    "#.##.....######.....##.#",
    "#.##.#.#.######.#.#.##.#",
    "#....#......#.....#....#",
    "#.##.###.##########.##.#",
    "#....###.##########....#",
    "#.##.###........###.##.#",
    "#.P#.####...###.###.##.#",
    "#.........#.........#..#",
    "########################"
  ]
}
