{
  "id": "maze3",
  "name": "Maze 3",
  "pattern": [
    "########################",
    "###....................#",
    "##.....................#",
    "#.#########..#########.#",
    "#.........#..#.........#",
    "#.........#..#.........#",
    "#.........#..#.........#",
    "#..#.##############.#..#",
    "#..#................#..#",
    "#..#................#..#",
    "#..#.....##E###.....#..#",
    "#.######.#HHHH#.######.#",
    "#..#.....#HGGH#.....#..#",
    "#..#.....#HGGH#.....#..#",
    "#........######........#",
    "#...######.##.######...#",
    "#..........##..........#",
    "#..........##..........#",
    "#..#.......##.......#..#",
    "#.######..####..######.#",
    "#..#................#..#",
    "#..#................#..#",
    "#..#................#..#",
    "#..#.##############.#..#",
    "#..#......#..#......#..#",
    "#..#......#..#......#..#",
    "#.........#..#.........#",
    "#.#########..#########.#",
    "#.........#..#.........#",
    "#.P.......#..#.........#",
    "#......................#",
    "########################"
  ]
}
