{
  "name": "Maze 1 - Central Ghost Cluster",
  "pattern": [
    "########################",
    "###....................#",
    "##.....................#",
    "#.#######......######..#",
    "#......................#",
    "#..........#...........#",
    "#.#####..######..#####.#",
    "#..........#...........#",
    "#....#.....#......#....#",
    "#....#............#....#",
    "#..######......######..#",
    "#....#............#....#",
    "#....#.....#......#....#",
    "#..........#...........#",
    "#.####.....#......####.#",
    "#........GG#GG.........#",
    "#......#...#....#......#",
    "#......#........#......#",
    "#..#######....#######..#",
    "#......#........#......#",
    "#......#...#....#......#",
    "#..........#...........#",
    "#.#####..######..#####.#",
    "#..........#...........#",
    "#...#......#.......#...#",
    "#...#..............#...#",
    "#..######......######..#",
    "#...#..............#...#",
    "#.P.#..............#...#",
    "#.....############.....#",
    "#......................#",
    "########################"
  ]
}
