{
  "id": "maze4",
  "name": "Maze 4",
  "pattern": [
    "########################",
    "###....................#",
    "##.........#...........#",
    "#.#........#...........#",
    "#..#######.#..#######..#",
    "#..........#...........#",
    "#..#.......#........#..#",
    "#..#................#..#",
    "#..#..############..#..#",
    "#..#................#..#",
    "#..#....#......#....#..#",
    "#.......#......#.......#",
    "#.#####.########.#####.#",
    "#.......#......#.......#",
    "#.#..##E###....#.....#.#",
    "#.#..#HHHH#..........#.#",
    "#.#.##HGGH#..#######.#.#",
    "#.#..#HGGH#..........#.#",
    "#.#..######....#.....#.#",
    "#.......#......#.......#",
    "#.#######.####.#######.#",
    "#.......#......#.......#",
    "#..#....#......#....#..#",
    "#..#................#..#",
    "#..#..############..#..#",
    "#..#................#..#",
    "#..#.......#........#..#",
    "#..#.......#........#..#",
    "#..#######.#..#######..#",
    "#..........#P..........#",
    "#..........#...........#",
    "########################"
  ]
}
