{
  "id": "maze1",
  "name": "Maze 1",
  "pattern": [
    "########################",
    "#...........#..........#",
    "#.#.##.####.####.#.###.#",
    "#.#....####.####.#.....#",
    "#.####.####.####.##.##.#",
    "#........#.....#.......#",
    "#.####.#.##.##.#.#####.#",
    "#.####......##...#####.#",
    "#.####.####.####.#####.#",
    "#....#...........#.....#",
    "#.##.#.####.####.##.##.#",
    "#....#.####.####.##....#",
    "#.####.####.####.#####.#",
    "#........##E###........#",
    "#.#.##.###HGHG########.#",
    "#.#.....##HHHH########.#",
    "#.########GHGH########.#",
    "#.####################.#",
    "#.........#............#",
    "#.####.#.##.####.#####.#",
    "#.####.#....####.....#.#",
    "#.####.####.####.#.#.#.#",
    "#............#.....#...#",
    "#.##.#.####.####.#####.#",
    "#....#.####.####.##....#",
    "#.####.####.####.#####.#",
    "#........#.....#.......#",
    "#.####.#.##.##.#.#####.#",
    "#.####......##...#####.#",
    "#.####.####.####.#####.#",
    "#.P.........#..........#",
    "########################"
  ]
}
