{
  "id": "maze5",
  "name": "Maze 5",
  "pattern": [
    "########################",
    "#......................#",
    "#.##.###.###.###.#####.#",
    "#.....##....P..#.#.....#",
    "#.##.###.###.###.#####.#",
    "#......................#",
    "#.##.###.###.###.#####.#",
    "#.##.....###.###.....#.#",
    "#.##.###.###.###.#####.#",
    "#......................#",
    "#....###.....####.####.#",
    "#.##.###.########.####.#",
    "#..............##E###..#",
    "#.######.#######HHHH##.#",
    "#.....##......##HGGH##.#",
    "#.######.#######HGGH##.#",
    "#.######.#############.#",
    "#......................#",
    "#.##.#######.###.#####.#",
    "#.##.....###.....#####.#",
    "#.##.#######.###.#####.#",
    "#......................#",
    "#.##.###.###.###.#####.#",
    "#....###.###.###.#.....#",
    "#.##.###.###.###.#####.#",
    "#......................#",
    "#.##.###.###.#########.#",
    "#.##.....###.....#####.#",
    "#.##.###.#############.#",
    "#......................#",
    "########.........#######",
    "########################"
  ]
}
