{
  "id": "maze4",
  "name": "Maze 4",
  "pattern": [
    "########################",
    "#...........#..........#",
    "#.###.####.###.###.###.#",
    "#.###.####.###.###.###.#",
    "#..#............#......#",
    "#.###.####.###.###.###.#",
    "#.###......###.....###.#",
    "#.###.#.##.###.###.###.#",
    "#.....#......#.........#",
    "#.###.####.###.###.###.#",
    "#.....####.###.###.....#",
    "#.###.####.###.###.###.#",
    "#...#......#...........#",
    "#..........#.#####.###.#",
    "#.####E###.........###.#",
    "#.###HGHG##.###.######.#",
    "#...#HHHH##.....####...#",
    "#.###GHGH#####.#######.#",
    "#.############.#######.#",
    "#...........#..........#",
    "#.###.####.###.###.###.#",
    "#.###......###.....###.#",
    "#.###.##.#.###.###.###.#",
    "#........#...........#.#",
    "#.###.####.###.###.#.#.#",
    "#.....####.###.###.....#",
    "#.###.####.###.###.#.#.#",
    "#............#.....#...#",
    "#.###.######.#.#######.#",
    "#.###.#.....P.....####.#",
    "#..........#...........#",
    "########################"
  ]
}
