{
  "id": "maze2",
  "name": "Maze 2",
  "pattern": [
    "########################",
    "#....#.................#",
    "#...#......#...........#",
    "#....#.....#...........#",
    "#....##############....#",
    "#..........#...........#",
    "#...#......#.......#...#",
    "#...#..............#...#",
    "#.#######......#######.#",
    "#...#..............#...#",
    "#...#......#.......#...#",
    "#..........#...........#",
    "#....#######.######....#",
    "#..........#...........#",
    "#......#...#....#......#",
    "#......#....P...#......#",
    "#.######.##E###.######.#",
    "#......#.#HHHH#.#......#",
    "#......#.#HGGH#.#......#",
    "#........#HGGH#........#",
    "#....##############....#",
    "#..........#...........#",
    "#...#......#.......#...#",
    "#...#..............#...#",
    "#.#######......#######.#",
    "#...#..............#...#",
    "#...#......#.......#...#",
    "#..........#...........#",
    "#....##############....#",
    "#..........#...........#",
    "#..........#...........#",
    "########################"
  ]
}
