{
  "name": "Maze 5 - Diagonal Ghosts",
  "pattern": [
    "########################",
    "###....................#",
    "##..........P..........#",
    "#.######.######..#####.#",
    "#........#.............#",
    "#...G....#.............#",
    "#........#.............#",
    "#..#.#######..#######..#",
    "#..#..............#....#",
    "#..#..............#....#",
    "#..#..............#....#",
    "#.#######G#########....#",
    "#..#......#......##....#",
    "#..#......#......##....#",
    "#.........#......#.....#",
    "#...##########.#######.#",
    "#...#.....#..#...#.....#",
    "#...#.....#..#...#.....#",
    "#...#........#G........#",
    "#.#######.#######....#.#",
    "#...#...#....#.......#.#",
    "#...#...#....#.......#.#",
    "#.......#............#.#",
    "#....########.########.#",
    "#.......#...#........#.#",
    "#.......#...#........#.#",
    "#...........#......G...#",
    "#.#######..######......#",
    "#...........#..........#",
    "#...........#.....####.#",
    "#......................#",
    "########################"
  ]
}
