{
  "name": "Maze 2 - Corner Ghosts",
  "pattern": [
    "########################",
    "#....#.................#",
    "#.G.#......#.........G.#",
    "#....#.....#...........#",
    "#....##############....#",
    "#..........#...........#",
    "#...#......#.......#...#",
    "#...#..............#...#",
    "#.#######......#######.#",
    "#...#..............#...#",
    "#...#......#.......#...#",
    "#..........#...........#",
    "#....#######.######....#",
    "#..........#...........#",
    "#......#...#....#......#",
    "#......#....P...#......#",
    "#.######.######.######.#",
    "#......#........#......#",
    "#......#...#....#......#",
    "#..........#...........#",
    "#....#######.######....#",
    "#..........#...........#",
    "#...#......#.......#...#",
    "#...#..............#...#",
    "#.#######......#######.#",
    "#...#..............#...#",
    "#...#......#.......#...#",
    "#..........#...........#",
    "#....##############....#",
    "#.G........#.........G.#",
    "#..........#...........#",
    "########################"
  ]
}
