{
  "name": "Maze 3 - Outer Side Ghosts",
  "pattern": [
    "########################",
    "###.........G..........#",
    "##.....................#",
    "#.#########..#########.#",
    "#.........#..#.........#",
    "#.........#..#.........#",
    "#.........#..#.........#",
    "#..#.##############.#..#",
    "#..#................#..#",
    "#..#................#..#",
    "#..#................#..#",
    "#.######..####..######.#",
    "#..#................#..#",
    "#..#.......##.......#..#",
    "#..........##..........#",
    "#...######.##.######...#",
    "#G.........##.........G#",
    "#..........##..........#",
    "#..#.......##.......#..#",
    "#.######..####..######.#",
    "#..#................#..#",
    "#..#................#..#",
    "#..#................#..#",
    "#..#.##############.#..#",
    "#..#......#..#......#..#",
    "#..#......#..#......#..#",
    "#.........#..#.........#",
    "#.#########..#########.#",
    "#.........#..#.........#",
    "#.P.......#..#.........#",
    "#...........G..........#",
    "########################"
  ]
}
